S_______
__B_____
__B_____
___BB___
_____B__
_____B__
___BB___
_______G