CCCSCCCCCCCCC
CMC_CM______C
C_C_CCCCC_C_C
C_______C_CMC
CCC_CCC_C_CCC
CMC_CM____C_G
C_C_CCCCCCC_C
C___C_____C_C
C_C_C_C_CCC_C
C_CMC_C___C_C
C_CCC_C_CCC_C
C_____C_____C
CCCCCCCCCCCCC